0 0 0 0 0 0 0 0 0 0 0
0 0 0 6 4 5 4 6 6 0 0
0 0 0 5 4 5 6 6 4 0 0
0 0 0 6 6 6 6 0 0 0 0
0 0 0 0 0 0 0 0 0 0 0
0 0 0 0 0 0 0 0 0 0 0
0 0 0 0 0 0 0 0 0 0 0
0 0 0 0 0 0 0 0 0 0 0
0 0 0 0 0 0 0 0 0 0 0
0 0 0 0 0 0 0 0 0 0 0